//MAP CONVERTED BY dmm2tgm.py THIS HEADER COMMENT PREVENTS RECONVERSION, DO NOT REMOVE
"an" = (
/obj/effect/light_emitter,
/obj/effect/decal/cleanable/dirt/dust,
/obj/effect/decal/cleanable/dirt/dust,
/turf/open/floor/stone{
	color = "#03fcf0"
	},
/area/ruin/space/has_grav/powered/skyrat/luna)
"ar" = (
/turf/open/misc/dirt{
	planetary_atmos = 0
	},
/area/ruin/space/has_grav/powered/skyrat/luna)
"ax" = (
/obj/effect/turf_decal/siding/thinplating_new/dark{
	dir = 8
	},
/turf/open/floor/stone{
	color = "#03fcf0"
	},
/area/ruin/space/has_grav/powered/skyrat/luna)
"bl" = (
/obj/effect/turf_decal/siding/thinplating_new{
	dir = 8
	},
/turf/open/floor/stone{
	color = "#03fcf0"
	},
/area/ruin/space/has_grav/powered/skyrat/luna)
"bp" = (
/turf/open/floor/stone{
	color = "#fceb03"
	},
/area/ruin/space/has_grav/powered/skyrat/luna)
"by" = (
/obj/structure/flora/bush/ferny,
/turf/open/misc/beach/sand,
/area/ruin/space/has_grav/powered/skyrat/luna)
"cc" = (
/obj/structure/flora/bush/leafy,
/turf/open/misc/dirt{
	planetary_atmos = 0
	},
/area/ruin/space/has_grav/powered/skyrat/luna)
"cG" = (
/obj/structure/railing{
	color = "#03fcf0";
	dir = 10
	},
/obj/effect/turf_decal/siding/blue{
	dir = 10
	},
/turf/open/floor/stone{
	color = "#03fcf0";
	initial_gas_mix = "TEMP=2.7"
	},
/area/ruin/space/has_grav/powered/skyrat/luna)
"cL" = (
/obj/effect/light_emitter,
/turf/open/floor/stone{
	color = "#fceb03"
	},
/area/ruin/space/has_grav/powered/skyrat/luna)
"cM" = (
/obj/effect/turf_decal/siding/thinplating{
	dir = 4
	},
/turf/open/floor/stone{
	color = "#03fcf0";
	initial_gas_mix = "TEMP=2.7"
	},
/area/ruin/space/has_grav/powered/skyrat/luna)
"cU" = (
/obj/effect/decal/cleanable/dirt/dust,
/obj/effect/turf_decal/siding/thinplating_new{
	dir = 1
	},
/turf/open/floor/stone{
	color = "#03fcf0"
	},
/area/ruin/space/has_grav/powered/skyrat/luna)
"cZ" = (
/obj/effect/decal/cleanable/dirt/dust,
/obj/effect/turf_decal/siding/thinplating_new/corner{
	dir = 1
	},
/turf/open/floor/stone{
	color = "#03fcf0"
	},
/area/ruin/space/has_grav/powered/skyrat/luna)
"dC" = (
/obj/structure/flora/bush/grassy,
/turf/open/misc/grass,
/area/ruin/space/has_grav/powered/skyrat/luna)
"dE" = (
/obj/structure/flora/biolumi/lamp/weaklight,
/obj/structure/flora/bush/leafy,
/turf/open/misc/grass,
/area/ruin/space/has_grav/powered/skyrat/luna)
"dG" = (
/turf/closed/wall/mineral/stone{
	color = "#03fcf0"
	},
/area/ruin/space/has_grav/powered/skyrat/luna)
"ee" = (
/turf/open/water/jungle{
	planetary_atmos = 0
	},
/area/ruin/space/has_grav/powered/skyrat/luna)
"eF" = (
/obj/structure/flora/bush/grassy,
/obj/structure/flora/bush/leafy,
/turf/open/misc/grass,
/area/ruin/space/has_grav/powered/skyrat/luna)
"fT" = (
/obj/structure/flora/tree/jungle/small,
/turf/open/misc/grass,
/area/ruin/space/has_grav/powered/skyrat/luna)
"fX" = (
/obj/effect/decal/cleanable/dirt/dust,
/turf/open/floor/pod{
	color = "#03fcf0"
	},
/area/ruin/space/has_grav/powered/skyrat/luna)
"hj" = (
/obj/structure/flora/bush/leafy,
/obj/structure/flora/bush/flowers_br,
/turf/open/misc/grass,
/area/ruin/space/has_grav/powered/skyrat/luna)
"hp" = (
/obj/structure/flora/bush/flowers_br,
/obj/structure/flora/bush/jungle,
/turf/open/misc/grass,
/area/ruin/space/has_grav/powered/skyrat/luna)
"hG" = (
/obj/effect/decal/cleanable/dirt/dust,
/obj/effect/turf_decal/siding/thinplating_new,
/turf/open/floor/stone{
	color = "#03fcf0"
	},
/area/ruin/space/has_grav/powered/skyrat/luna)
"hN" = (
/obj/structure/flora/biolumi,
/turf/open/misc/grass,
/area/ruin/space/has_grav/powered/skyrat/luna)
"il" = (
/obj/item/food/grown/moonflower{
	pixel_y = -6
	},
/obj/structure/flora/bush/jungle/c/style_2,
/turf/open/misc/grass,
/area/ruin/space/has_grav/powered/skyrat/luna)
"iv" = (
/turf/open/floor/stone{
	color = "#03fcf0"
	},
/area/ruin/space/has_grav/powered/skyrat/luna)
"ko" = (
/obj/effect/decal/cleanable/dirt/dust,
/turf/open/floor/stone{
	color = "#03fcf0"
	},
/area/ruin/space/has_grav/powered/skyrat/luna)
"lb" = (
/obj/structure/flora/bush/flowers_br,
/obj/structure/flora/bush/leafy,
/obj/structure/flora/bush/flowers_pp,
/turf/open/misc/grass,
/area/ruin/space/has_grav/powered/skyrat/luna)
"lh" = (
/turf/open/misc/beach/sand,
/area/ruin/space/has_grav/powered/skyrat/luna)
"lB" = (
/turf/open/misc/grass,
/area/ruin/space/has_grav/powered/skyrat/luna)
"lD" = (
/turf/template_noop,
/area/space)
"lE" = (
/turf/open/floor/stone{
	color = "#03fcf0";
	initial_gas_mix = "TEMP=2.7"
	},
/area/ruin/space/has_grav/powered/skyrat/luna)
"lO" = (
/obj/structure/flora/bush/flowers_pp,
/turf/open/misc/grass,
/area/ruin/space/has_grav/powered/skyrat/luna)
"mN" = (
/obj/structure/flora/rock,
/turf/open/misc/grass,
/area/ruin/space/has_grav/powered/skyrat/luna)
"ni" = (
/obj/structure/flora/bush/lavendergrass,
/turf/open/misc/beach/sand,
/area/ruin/space/has_grav/powered/skyrat/luna)
"nx" = (
/obj/structure/flora/bush/lavendergrass,
/turf/open/misc/grass,
/area/ruin/space/has_grav/powered/skyrat/luna)
"oj" = (
/obj/structure/flora/bush/leafy,
/obj/structure/flora/bush/flowers_pp,
/turf/open/misc/grass,
/area/ruin/space/has_grav/powered/skyrat/luna)
"oT" = (
/obj/structure/railing{
	color = "#03fcf0";
	dir = 6
	},
/obj/effect/turf_decal/siding/blue{
	dir = 6
	},
/turf/open/floor/stone{
	color = "#03fcf0";
	initial_gas_mix = "TEMP=2.7"
	},
/area/ruin/space/has_grav/powered/skyrat/luna)
"pf" = (
/obj/effect/decal/cleanable/dirt/dust,
/obj/effect/decal/cleanable/dirt/dust,
/turf/open/floor/stone{
	color = "#03fcf0"
	},
/area/ruin/space/has_grav/powered/skyrat/luna)
"pT" = (
/turf/open/floor/pod{
	color = "#03fcf0"
	},
/area/ruin/space/has_grav/powered/skyrat/luna)
"qD" = (
/obj/structure/flora/bush/flowers_pp,
/obj/structure/flora/bush/flowers_br,
/turf/open/misc/grass,
/area/ruin/space/has_grav/powered/skyrat/luna)
"qR" = (
/obj/structure/flora/biolumi/mine/weaklight,
/obj/structure/flora/bush/flowers_br,
/turf/open/misc/grass,
/area/ruin/space/has_grav/powered/skyrat/luna)
"rq" = (
/obj/effect/decal/cleanable/dirt/dust,
/obj/effect/turf_decal/siding/thinplating_new{
	dir = 8
	},
/turf/open/floor/stone{
	color = "#03fcf0"
	},
/area/ruin/space/has_grav/powered/skyrat/luna)
"rw" = (
/obj/effect/decal/cleanable/dirt/dust,
/obj/effect/decal/cleanable/dirt/dust,
/obj/effect/turf_decal/trimline/dark_blue/line{
	dir = 4
	},
/turf/open/floor/stone{
	color = "#03fcf0"
	},
/area/ruin/space/has_grav/powered/skyrat/luna)
"sh" = (
/obj/effect/decal/cleanable/dirt/dust,
/obj/structure/flora/bush/jungle/c/style_3,
/turf/open/misc/grass,
/area/ruin/space/has_grav/powered/skyrat/luna)
"sY" = (
/obj/structure/flora/bush/sparsegrass,
/turf/open/misc/grass,
/area/ruin/space/has_grav/powered/skyrat/luna)
"tn" = (
/obj/structure/flora/bush/leafy,
/obj/structure/flora/bush/grassy,
/turf/open/misc/grass,
/area/ruin/space/has_grav/powered/skyrat/luna)
"tt" = (
/obj/effect/turf_decal/siding/thinplating{
	dir = 1
	},
/turf/open/floor/stone{
	color = "#03fcf0";
	initial_gas_mix = "TEMP=2.7"
	},
/area/ruin/space/has_grav/powered/skyrat/luna)
"tQ" = (
/turf/open/misc/asteroid/airless,
/area/ruin/unpowered)
"ur" = (
/obj/structure/flora/bush/reed/style_random,
/turf/open/misc/dirt{
	planetary_atmos = 0
	},
/area/ruin/space/has_grav/powered/skyrat/luna)
"us" = (
/obj/structure/flora/biolumi/flower/weaklight,
/obj/structure/flora/bush/grassy,
/turf/open/misc/grass,
/area/ruin/space/has_grav/powered/skyrat/luna)
"uM" = (
/obj/structure/flora/bush/flowers_br,
/turf/open/misc/grass,
/area/ruin/space/has_grav/powered/skyrat/luna)
"vn" = (
/obj/structure/flora/bush/jungle,
/turf/open/misc/grass,
/area/ruin/space/has_grav/powered/skyrat/luna)
"vp" = (
/obj/structure/flora/bush/flowers_yw,
/turf/open/misc/grass,
/area/ruin/space/has_grav/powered/skyrat/luna)
"wa" = (
/obj/effect/decal/cleanable/dirt/dust,
/turf/open/floor/stone,
/area/ruin/space/has_grav/powered/skyrat/luna)
"wL" = (
/obj/structure/flora/bush/jungle/a/style_3,
/turf/open/misc/grass,
/area/ruin/space/has_grav/powered/skyrat/luna)
"wS" = (
/obj/effect/light_emitter,
/obj/effect/decal/cleanable/dirt/dust,
/turf/open/floor/stone,
/area/ruin/space/has_grav/powered/skyrat/luna)
"wY" = (
/obj/structure/railing{
	color = "#03fcf0"
	},
/obj/effect/turf_decal/siding/blue,
/turf/open/floor/stone{
	color = "#03fcf0";
	initial_gas_mix = "TEMP=2.7"
	},
/area/ruin/space/has_grav/powered/skyrat/luna)
"xg" = (
/obj/structure/railing{
	color = "#03fcf0";
	dir = 8
	},
/obj/effect/turf_decal/siding/blue{
	dir = 8
	},
/turf/open/floor/stone{
	color = "#03fcf0";
	initial_gas_mix = "TEMP=2.7"
	},
/area/ruin/space/has_grav/powered/skyrat/luna)
"xC" = (
/obj/structure/railing{
	color = "#03fcf0";
	dir = 4
	},
/obj/effect/turf_decal/siding/blue{
	dir = 4
	},
/obj/effect/turf_decal/siding/thinplating{
	dir = 8
	},
/turf/open/floor/stone{
	color = "#03fcf0";
	initial_gas_mix = "TEMP=2.7"
	},
/area/ruin/space/has_grav/powered/skyrat/luna)
"ye" = (
/obj/machinery/door/airlock/hatch{
	color = "#03fcf0"
	},
/obj/effect/decal/cleanable/dirt/dust,
/obj/effect/mapping_helpers/airlock/cutaiwire,
/obj/effect/mapping_helpers/airlock/locked,
/obj/effect/turf_decal/trimline/dark_blue/warning,
/turf/open/floor/stone{
	color = "#03fcf0"
	},
/area/ruin/space/has_grav/powered/skyrat/luna)
"yg" = (
/turf/open/floor/stone,
/area/ruin/space/has_grav/powered/skyrat/luna)
"yh" = (
/obj/structure/flora/bush/flowers_pp,
/obj/structure/flora/bush/grassy,
/turf/open/misc/grass,
/area/ruin/space/has_grav/powered/skyrat/luna)
"yi" = (
/obj/effect/turf_decal/siding/thinplating_new/corner{
	dir = 8
	},
/turf/open/floor/stone{
	color = "#03fcf0"
	},
/area/ruin/space/has_grav/powered/skyrat/luna)
"yU" = (
/obj/structure/flora/biolumi/lamp/weaklight,
/turf/open/misc/grass,
/area/ruin/space/has_grav/powered/skyrat/luna)
"zq" = (
/obj/structure/flora/bush/flowers_br,
/obj/structure/flora/bush/leafy,
/turf/open/misc/grass,
/area/ruin/space/has_grav/powered/skyrat/luna)
"As" = (
/obj/structure/flora/rock/pile,
/turf/open/misc/grass,
/area/ruin/space/has_grav/powered/skyrat/luna)
"Bi" = (
/obj/effect/turf_decal/siding/thinplating/corner{
	dir = 4
	},
/turf/open/floor/stone{
	color = "#03fcf0";
	initial_gas_mix = "TEMP=2.7"
	},
/area/ruin/space/has_grav/powered/skyrat/luna)
"BP" = (
/obj/structure/flora/bush/flowers_br,
/obj/structure/flora/bush/flowers_pp,
/turf/open/misc/grass,
/area/ruin/space/has_grav/powered/skyrat/luna)
"Cx" = (
/obj/structure/mineral_door/iron{
	color = "#03fcf0"
	},
/obj/effect/decal/cleanable/dirt/dust,
/obj/effect/turf_decal/trimline/dark_blue/warning{
	dir = 1
	},
/turf/open/floor/stone{
	color = "#03fcf0"
	},
/area/ruin/space/has_grav/powered/skyrat/luna)
"CV" = (
/obj/effect/decal/cleanable/dirt/dust,
/obj/effect/turf_decal/trimline/dark_blue/line{
	dir = 4
	},
/turf/open/floor/stone{
	color = "#03fcf0"
	},
/area/ruin/space/has_grav/powered/skyrat/luna)
"CW" = (
/obj/structure/flora/bush/fullgrass,
/turf/open/misc/grass,
/area/ruin/space/has_grav/powered/skyrat/luna)
"CZ" = (
/obj/effect/decal/cleanable/dirt/dust,
/turf/open/floor/stone{
	color = "#fc8403"
	},
/area/ruin/space/has_grav/powered/skyrat/luna)
"Da" = (
/obj/effect/light_emitter,
/obj/item/melee/sabre/luna,
/obj/structure/flora/rock/style_3,
/turf/open/misc/grass,
/area/ruin/space/has_grav/powered/skyrat/luna)
"Db" = (
/obj/effect/turf_decal/siding/thinplating_new/dark{
	dir = 4
	},
/turf/open/floor/stone{
	color = "#03fcf0"
	},
/area/ruin/space/has_grav/powered/skyrat/luna)
"DU" = (
/obj/effect/decal/cleanable/dirt/dust,
/obj/effect/turf_decal/siding/thinplating_new/dark{
	dir = 4
	},
/turf/open/floor/stone{
	color = "#fc8403"
	},
/area/ruin/space/has_grav/powered/skyrat/luna)
"Fo" = (
/turf/closed/mineral/random,
/area/ruin/unpowered)
"Fv" = (
/obj/structure/flora/grass/jungle,
/turf/open/misc/grass,
/area/ruin/space/has_grav/powered/skyrat/luna)
"GI" = (
/obj/effect/decal/cleanable/dirt/dust,
/obj/effect/turf_decal/siding/wideplating_new{
	dir = 4
	},
/obj/effect/turf_decal/siding/wideplating_new{
	dir = 8
	},
/turf/open/floor/stone,
/area/ruin/space/has_grav/powered/skyrat/luna)
"IA" = (
/mob/living/simple_animal/hostile/carp{
	dir = 8
	},
/turf/open/misc/asteroid/airless,
/area/ruin/unpowered)
"Jk" = (
/obj/effect/decal/cleanable/dirt/dust,
/obj/structure/flora/bush/sparsegrass,
/turf/open/misc/grass,
/area/ruin/space/has_grav/powered/skyrat/luna)
"JC" = (
/obj/effect/decal/cleanable/dirt/dust,
/obj/effect/turf_decal/siding/thinplating_new/dark{
	dir = 4
	},
/turf/open/floor/stone{
	color = "#03fcf0"
	},
/area/ruin/space/has_grav/powered/skyrat/luna)
"JF" = (
/obj/structure/railing,
/obj/effect/turf_decal/siding/thinplating_new/dark,
/turf/open/floor/pod{
	color = "#03fcf0"
	},
/area/ruin/space/has_grav/powered/skyrat/luna)
"KF" = (
/obj/effect/decal/cleanable/dirt/dust,
/turf/open/floor/stone{
	color = "#fceb03"
	},
/area/ruin/space/has_grav/powered/skyrat/luna)
"Lz" = (
/obj/structure/railing{
	color = "#03fcf0";
	dir = 4
	},
/obj/effect/turf_decal/siding/blue{
	dir = 4
	},
/obj/effect/turf_decal/siding/thinplating/corner{
	dir = 1
	},
/turf/open/floor/stone{
	color = "#03fcf0";
	initial_gas_mix = "TEMP=2.7"
	},
/area/ruin/space/has_grav/powered/skyrat/luna)
"Mk" = (
/obj/structure/flora/biolumi/mine/weaklight,
/turf/open/misc/grass,
/area/ruin/space/has_grav/powered/skyrat/luna)
"Mv" = (
/obj/effect/decal/cleanable/dirt/dust,
/obj/effect/turf_decal/siding/thinplating_new/corner{
	dir = 4
	},
/turf/open/floor/stone{
	color = "#03fcf0"
	},
/area/ruin/space/has_grav/powered/skyrat/luna)
"My" = (
/obj/effect/decal/cleanable/dirt/dust,
/obj/effect/turf_decal/trimline/dark_blue/line{
	dir = 8
	},
/turf/open/floor/stone{
	color = "#03fcf0"
	},
/area/ruin/space/has_grav/powered/skyrat/luna)
"MG" = (
/obj/machinery/quantumpad{
	desc = "A bluespace quantum-linked telepad used for teleporting objects to other quantum pads. This one seems crudely modified - though whatever effects it was meant to have seem inert. The modifications look frail...";
	name = "modified quantum pad"
	},
/obj/effect/turf_decal/tile/dark_red/fourcorners,
/turf/open/floor/iron/dark/airless,
/area/ruin/space/has_grav/powered/skyrat/luna)
"MU" = (
/obj/effect/decal/cleanable/dirt/dust,
/obj/effect/decal/cleanable/dirt/dust,
/obj/effect/decal/cleanable/dirt/dust,
/turf/open/floor/stone{
	color = "#03fcf0"
	},
/area/ruin/space/has_grav/powered/skyrat/luna)
"Ng" = (
/obj/effect/decal/cleanable/dirt/dust,
/turf/open/misc/grass,
/area/ruin/space/has_grav/powered/skyrat/luna)
"NJ" = (
/obj/effect/decal/cleanable/dirt/dust,
/obj/effect/turf_decal/siding/thinplating_new{
	dir = 4
	},
/turf/open/floor/stone{
	color = "#03fcf0"
	},
/area/ruin/space/has_grav/powered/skyrat/luna)
"OR" = (
/obj/structure/flora/bush/flowers_br,
/obj/structure/flora/bush/grassy,
/turf/open/misc/grass,
/area/ruin/space/has_grav/powered/skyrat/luna)
"Pj" = (
/obj/effect/turf_decal/siding/wideplating_new{
	dir = 4
	},
/obj/effect/turf_decal/siding/wideplating_new{
	dir = 8
	},
/turf/open/floor/stone,
/area/ruin/space/has_grav/powered/skyrat/luna)
"PJ" = (
/turf/open/floor/stone{
	color = "#fc8403"
	},
/area/ruin/space/has_grav/powered/skyrat/luna)
"QL" = (
/obj/structure/flora/bush/flowers_br,
/obj/structure/flora/bush/flowers_yw,
/turf/open/misc/grass,
/area/ruin/space/has_grav/powered/skyrat/luna)
"Rl" = (
/obj/effect/decal/cleanable/dirt/dust,
/obj/effect/turf_decal/siding/thinplating_new/dark,
/obj/effect/turf_decal/siding/thinplating_new/dark{
	dir = 1
	},
/turf/open/floor/pod{
	color = "#03fcf0"
	},
/area/ruin/space/has_grav/powered/skyrat/luna)
"Rp" = (
/obj/effect/light_emitter,
/turf/open/floor/stone{
	color = "#03fcf0";
	initial_gas_mix = "TEMP=2.7"
	},
/area/ruin/space/has_grav/powered/skyrat/luna)
"RZ" = (
/obj/structure/flora/bush/grassy,
/obj/structure/flora/bush/flowers_br,
/turf/open/misc/beach/sand,
/area/ruin/space/has_grav/powered/skyrat/luna)
"Sj" = (
/obj/structure/railing{
	color = "#03fcf0"
	},
/obj/effect/turf_decal/siding/blue,
/obj/item/wrench,
/turf/open/floor/stone{
	color = "#03fcf0";
	initial_gas_mix = "TEMP=2.7"
	},
/area/ruin/space/has_grav/powered/skyrat/luna)
"Sl" = (
/obj/structure/flora/bush/stalky,
/obj/structure/flora/bush/flowers_yw,
/obj/structure/flora/bush/flowers_pp,
/turf/open/misc/grass,
/area/ruin/space/has_grav/powered/skyrat/luna)
"Tj" = (
/obj/structure/flora/bush/jungle/b,
/turf/open/misc/grass,
/area/ruin/space/has_grav/powered/skyrat/luna)
"Tt" = (
/obj/structure/flora/biolumi/flower/weaklight,
/turf/open/misc/grass,
/area/ruin/space/has_grav/powered/skyrat/luna)
"TH" = (
/mob/living/simple_animal/hostile/carp,
/turf/open/misc/asteroid/airless,
/area/ruin/unpowered)
"TO" = (
/obj/effect/turf_decal/siding/thinplating_new/corner,
/turf/open/floor/stone{
	color = "#03fcf0"
	},
/area/ruin/space/has_grav/powered/skyrat/luna)
"Vd" = (
/obj/effect/decal/cleanable/dirt/dust,
/obj/effect/turf_decal/siding/thinplating_new/dark{
	dir = 8
	},
/turf/open/floor/stone{
	color = "#03fcf0"
	},
/area/ruin/space/has_grav/powered/skyrat/luna)
"Vs" = (
/obj/structure/flora/bush/leafy,
/turf/open/misc/grass,
/area/ruin/space/has_grav/powered/skyrat/luna)
"Wf" = (
/obj/structure/flora/tree/jungle,
/turf/open/misc/grass,
/area/ruin/space/has_grav/powered/skyrat/luna)
"Wn" = (
/obj/structure/window/fulltile{
	color = "#03fcf0"
	},
/turf/open/floor/plating{
	color = "#03fcf0"
	},
/area/ruin/space/has_grav/powered/skyrat/luna)
"YO" = (
/obj/effect/turf_decal/siding/thinplating_new/dark,
/obj/effect/turf_decal/siding/thinplating_new/dark{
	dir = 1
	},
/turf/open/floor/pod{
	color = "#03fcf0"
	},
/area/ruin/space/has_grav/powered/skyrat/luna)
"YT" = (
/obj/structure/flora/biolumi/flower/weaklight,
/obj/structure/flora/bush/flowers_br,
/turf/open/misc/grass,
/area/ruin/space/has_grav/powered/skyrat/luna)
"ZE" = (
/obj/effect/decal/cleanable/dirt/dust,
/obj/structure/flora/bush/flowers_br,
/turf/open/misc/grass,
/area/ruin/space/has_grav/powered/skyrat/luna)
"ZJ" = (
/obj/effect/turf_decal/trimline/dark_blue/line{
	dir = 8
	},
/turf/open/floor/stone{
	color = "#03fcf0"
	},
/area/ruin/space/has_grav/powered/skyrat/luna)
"ZW" = (
/obj/effect/light_emitter,
/turf/open/floor/stone{
	color = "#03fcf0"
	},
/area/ruin/space/has_grav/powered/skyrat/luna)

(1,1,1) = {"
lD
lD
lD
lD
lD
lD
lD
lD
lD
lD
lD
lD
lD
Fo
Fo
Fo
Fo
Fo
Fo
Fo
Fo
Fo
Fo
lD
lD
lD
Fo
Fo
Fo
Fo
lD
lD
lD
lD
lD
lD
lD
lD
lD
lD
lD
lD
lD
lD
lD
lD
lD
lD
lD
lD
"}
(2,1,1) = {"
lD
lD
lD
lD
lD
lD
lD
lD
lD
lD
lD
Fo
Fo
Fo
Fo
Fo
Fo
Fo
Fo
Fo
Fo
Fo
Fo
Fo
Fo
Fo
Fo
Fo
Fo
Fo
Fo
lD
lD
lD
lD
lD
lD
lD
lD
lD
lD
lD
lD
lD
lD
lD
lD
lD
lD
lD
"}
(3,1,1) = {"
lD
lD
lD
lD
lD
lD
lD
lD
lD
lD
Fo
Fo
Fo
Fo
Fo
Fo
Fo
Fo
Fo
Fo
Fo
Fo
Fo
Fo
Fo
Fo
Fo
Fo
Fo
Fo
Fo
Fo
Fo
lD
lD
lD
lD
lD
lD
lD
lD
lD
lD
lD
lD
lD
lD
lD
lD
lD
"}
(4,1,1) = {"
lD
lD
lD
lD
lD
lD
lD
lD
lD
Fo
Fo
Fo
Fo
Fo
Fo
Fo
Fo
Fo
Fo
Fo
Fo
Fo
Fo
Fo
Fo
Fo
Fo
Fo
Fo
Fo
Fo
Fo
Fo
lD
lD
lD
lD
lD
lD
lD
lD
lD
lD
lD
lD
lD
lD
lD
lD
lD
"}
(5,1,1) = {"
lD
lD
lD
lD
lD
lD
lD
lD
Fo
Fo
Fo
Fo
Fo
Fo
Fo
dG
dG
dG
dG
dG
dG
dG
dG
dG
dG
dG
dG
dG
dG
dG
Fo
Fo
Fo
Fo
Fo
lD
lD
lD
lD
lD
lD
lD
lD
lD
lD
lD
lD
lD
lD
lD
"}
(6,1,1) = {"
lD
lD
lD
lD
lD
lD
lD
Fo
Fo
Fo
Fo
Fo
Fo
Fo
Fo
dG
pT
pT
pT
pT
pT
pT
pT
pT
pT
fX
fX
pT
pT
dG
lB
Fo
Fo
Fo
Fo
Fo
lD
lD
lD
lD
lD
lD
lD
lD
lD
lD
lD
lD
lD
lD
"}
(7,1,1) = {"
lD
lD
lD
lD
lD
lD
Fo
Fo
Fo
Fo
Fo
Fo
Fo
Fo
Fo
dG
ax
Vd
ax
ax
ax
ax
ax
Vd
Vd
ax
ax
Vd
ax
dG
lB
Fv
Fo
Fo
Fo
Fo
Fo
lD
lD
lD
lD
lD
lD
lD
lD
lD
lD
lD
lD
lD
"}
(8,1,1) = {"
lD
lD
lD
lD
lD
lD
Fo
Fo
Fo
Fo
Fo
Fo
Fo
Fo
Fo
dG
ko
ko
ko
iv
iv
bp
KF
KF
iv
iv
iv
ko
iv
dG
lB
lB
lB
Fo
Fo
Fo
Fo
Fo
lD
lD
lD
lD
lD
lD
lD
lD
lD
lD
lD
lD
"}
(9,1,1) = {"
lD
lD
lD
lD
lD
Fo
Fo
Fo
Fo
Fo
Fo
Fo
Fo
Fo
Fo
dG
ko
iv
ko
ko
bp
bp
KF
bp
bp
iv
ko
ko
iv
dG
lB
uM
lB
Fo
Fo
Fo
Fo
Fo
Fo
lD
lD
lD
lD
lD
lD
lD
lD
lD
lD
lD
"}
(10,1,1) = {"
lD
lD
lD
lD
Fo
Fo
Fo
Fo
Fo
Fo
Fo
Fo
Fo
Fo
Fo
dG
iv
iv
iv
KF
KF
yg
KF
yg
bp
bp
ko
iv
iv
dG
lB
lB
uM
lB
lB
lB
Fo
Fo
Fo
Fo
Fo
Fo
lD
lD
lD
lD
lD
lD
lD
lD
"}
(11,1,1) = {"
lD
lD
lD
lD
Fo
Fo
Fo
Fo
Fo
Fo
Fo
Fo
Fo
Fo
Fo
dG
ko
iv
bp
bp
bp
KF
bp
bp
bp
bp
KF
iv
iv
dG
lB
lB
uM
lB
lB
Wf
lB
lB
Fo
Fo
Fo
Fo
Fo
Fo
lD
lD
lD
lD
lD
lD
"}
(12,1,1) = {"
lD
lD
lD
Fo
Fo
Fo
Fo
Fo
Fo
Fo
Fo
Fo
Fo
Fo
Fo
dG
ko
iv
bp
KF
wa
KF
wS
wa
yg
bp
KF
iv
iv
dG
lB
lB
vn
YT
lB
lB
lB
Tj
lB
Fo
Fo
Fo
Fo
Fo
Fo
lD
lD
lD
lD
lD
"}
(13,1,1) = {"
lD
lD
lD
Fo
Fo
Fo
Fo
Fo
Fo
Fo
Fo
Fo
Fo
Fo
Fo
dG
iv
ko
bp
KF
bp
bp
KF
yg
KF
KF
bp
iv
iv
dG
lB
lB
Wf
lB
uM
lB
fT
CW
lB
lB
lB
Fo
Fo
Fo
Fo
Fo
lD
lD
lD
lD
"}
(14,1,1) = {"
lD
lD
Fo
Fo
Fo
Fo
Fo
Fo
Fo
Fo
Fo
Fo
Fo
Fo
Fo
dG
iv
ko
iv
KF
bp
bp
wa
KF
bp
KF
iv
iv
iv
dG
lB
lB
lB
lB
hN
uM
qR
As
lB
dC
lB
lB
lB
lB
Fo
Fo
Fo
lD
lD
lD
"}
(15,1,1) = {"
lD
lD
Fo
Fo
Fo
Fo
Fo
Fo
Fo
Fo
Fo
Fo
Fo
Fo
Fo
dG
iv
iv
ko
ko
bp
bp
bp
KF
bp
ko
ko
iv
iv
dG
lB
lB
lB
Tj
lB
vp
QL
QL
Tt
dC
dC
lB
wL
nx
Fv
Fo
Fo
Fo
lD
lD
"}
(16,1,1) = {"
lD
Fo
Fo
Fo
Fo
Fo
Fo
Fo
Fo
Fo
Fo
Fo
Fo
Fo
Fo
dG
iv
iv
iv
iv
ko
bp
KF
bp
ko
iv
ko
iv
iv
dG
lB
lB
yU
lB
mN
lB
uM
lh
RZ
lB
vp
lB
lh
ni
lB
Fo
Fo
Fo
Fo
lD
"}
(17,1,1) = {"
lD
Fo
Fo
Fo
Fo
Fo
Fo
Fo
dG
dG
dG
dG
dG
dG
dG
dG
iv
iv
ko
ko
ko
ko
ko
ko
iv
iv
ko
iv
iv
dG
lB
lB
lh
by
ee
ee
ee
ee
ee
ee
ee
ee
ee
ee
ni
Fo
Fo
Fo
Fo
Fo
"}
(18,1,1) = {"
Fo
Fo
Fo
Fo
Fo
Fo
Fo
Fo
dG
iv
iv
ko
ko
iv
iv
dG
iv
ko
ko
ko
ko
iv
ko
iv
iv
ko
ko
iv
iv
dG
ee
ee
ee
ee
ee
ee
ee
ee
ee
ee
ee
ee
ee
ee
ee
dG
xg
xg
cG
TH
"}
(19,1,1) = {"
Fo
Fo
Fo
Fo
Fo
Fo
Fo
dG
dG
TO
NJ
NJ
NJ
Mv
iv
dG
Pj
GI
GI
Pj
GI
Pj
GI
Pj
Pj
Pj
GI
Pj
Pj
dG
dG
dG
dG
Wn
dG
dG
dG
Wn
dG
dG
dG
Wn
dG
dG
dG
dG
lE
lE
wY
tQ
"}
(20,1,1) = {"
Fo
Fo
Fo
Fo
Fo
Fo
Fo
dG
JF
hG
ZE
vn
il
cU
iv
Rl
ko
ko
ko
iv
iv
iv
iv
iv
iv
ko
ko
iv
iv
dG
My
ZJ
ZJ
ZJ
My
My
My
My
My
My
My
My
ZJ
My
My
dG
lE
lE
Sj
tQ
"}
(21,1,1) = {"
Fo
Fo
Fo
Fo
Fo
Fo
Fo
dG
JF
hG
lB
Da
Ng
cU
ko
Rl
ko
ko
ko
ko
ko
iv
ko
iv
ko
iv
ko
ko
ko
Cx
pf
MU
pf
an
ko
ko
ko
an
pf
ko
iv
ZW
pf
MU
ko
ye
lE
Rp
wY
tQ
"}
(22,1,1) = {"
Fo
Fo
Fo
Fo
Fo
Fo
Fo
dG
JF
hG
sh
Ng
Jk
cU
ko
YO
iv
ko
ko
ko
ko
ko
ko
ko
ko
ko
ko
iv
iv
dG
CV
rw
CV
CV
rw
rw
CV
CV
CV
rw
rw
rw
CV
rw
CV
dG
cM
Bi
wY
tQ
"}
(23,1,1) = {"
Fo
Fo
Fo
Fo
Fo
Fo
Fo
dG
dG
yi
rq
bl
rq
cZ
ko
dG
Pj
Pj
GI
GI
Pj
Pj
GI
Pj
Pj
Pj
GI
GI
Pj
dG
dG
dG
dG
Wn
dG
dG
dG
Wn
dG
dG
dG
Wn
dG
dG
dG
dG
MG
tt
wY
tQ
"}
(24,1,1) = {"
Fo
Fo
Fo
Fo
Fo
Fo
Fo
Fo
dG
iv
ko
ko
ko
iv
iv
dG
iv
iv
ko
ko
iv
ko
ko
iv
iv
ko
ko
ko
iv
dG
ee
ee
ee
ar
lh
ee
ee
ar
lB
lB
lB
wL
lB
lh
ee
dG
xC
Lz
oT
tQ
"}
(25,1,1) = {"
Fo
Fo
Fo
Fo
Fo
Fo
Fo
Fo
dG
dG
dG
dG
dG
dG
dG
dG
iv
ko
ko
ko
ko
ko
CZ
iv
ko
ko
iv
ko
iv
dG
ee
ur
ar
sY
lB
cc
ar
Vs
tn
lB
lO
lB
lB
Fv
Fo
Fo
Fo
Fo
tQ
tQ
"}
(26,1,1) = {"
Fo
Fo
Fo
Fo
Fo
Fo
Fo
Fo
Fo
Fo
Fo
Fo
Fo
Fo
Fo
dG
iv
ko
PJ
iv
ko
CZ
KF
PJ
iv
ko
PJ
iv
iv
dG
ar
Tj
lB
uM
lB
Vs
vn
lB
dC
lb
Vs
Vs
lB
Fo
Fo
Fo
Fo
tQ
tQ
lD
"}
(27,1,1) = {"
Fo
Fo
Fo
Fo
Fo
Fo
Fo
Fo
Fo
Fo
Fo
Fo
Fo
Fo
Fo
dG
iv
CZ
bp
PJ
iv
CZ
KF
CZ
ko
PJ
KF
CZ
iv
dG
lB
lB
lB
uM
hj
Sl
yh
yh
Tt
oj
Vs
uM
lB
Fo
Fo
Fo
Fo
Fo
tQ
lD
"}
(28,1,1) = {"
Fo
Fo
Fo
Fo
Fo
Fo
Fo
Fo
Fo
Fo
Fo
Fo
Fo
Fo
Fo
dG
iv
ko
PJ
KF
CZ
KF
KF
KF
PJ
bp
CZ
iv
ko
dG
lB
lB
dE
eF
qD
dC
lB
lB
lB
lB
Vs
lB
Fo
Fo
Fo
Fo
Fo
Fo
Fo
lD
"}
(29,1,1) = {"
Fo
Fo
Fo
Fo
Fo
Fo
Fo
Fo
Fo
Fo
Fo
Fo
Fo
Fo
Fo
dG
ko
iv
CZ
PJ
bp
bp
bp
bp
KF
PJ
CZ
iv
ko
dG
lB
uM
Vs
dC
yh
dC
lB
fT
lB
oj
lB
lB
Fo
Fo
Fo
Fo
Fo
Fo
Fo
Fo
"}
(30,1,1) = {"
Fo
Fo
Fo
Fo
Fo
Fo
Fo
Fo
Fo
Fo
Fo
Fo
Fo
Fo
Fo
dG
ko
CZ
KF
KF
bp
bp
cL
KF
bp
KF
KF
CZ
iv
dG
lB
uM
zq
yh
hN
lB
lB
lO
lb
lB
lB
Fo
Fo
Fo
Fo
Fo
Fo
Fo
Fo
lD
"}
(31,1,1) = {"
lD
Fo
Fo
Fo
Fo
Fo
Fo
Fo
Fo
Fo
Fo
Fo
Fo
Fo
Fo
dG
iv
ko
CZ
CZ
bp
bp
bp
bp
KF
CZ
CZ
ko
iv
dG
lB
lB
OR
OR
lB
wL
Mk
oj
lB
lB
Fo
Fo
Fo
Fo
Fo
Fo
Fo
lD
lD
lD
"}
(32,1,1) = {"
lD
lD
Fo
Fo
Fo
Fo
Fo
Fo
Fo
Fo
Fo
Fo
Fo
Fo
Fo
dG
ko
ko
PJ
KF
PJ
bp
bp
bp
PJ
bp
CZ
ko
iv
dG
lB
lB
dC
BP
lO
lO
lO
Vs
lB
Fo
Fo
Fo
Fo
Fo
Fo
Fo
lD
lD
lD
lD
"}
(33,1,1) = {"
lD
lD
Fo
Fo
Fo
Fo
Fo
Fo
Fo
Fo
Fo
Fo
Fo
Fo
Fo
dG
ko
PJ
bp
PJ
ko
PJ
bp
PJ
iv
PJ
KF
CZ
ko
dG
lB
lB
us
uM
lB
zq
zq
lB
Fo
Fo
Fo
Fo
Fo
Fo
lD
lD
lD
lD
lD
lD
"}
(34,1,1) = {"
lD
Fo
Fo
Fo
Fo
Fo
Fo
Fo
Fo
Fo
Fo
Fo
Fo
Fo
Fo
dG
ko
iv
PJ
iv
iv
CZ
bp
PJ
ko
ko
PJ
ko
iv
dG
lB
lB
lB
lB
hp
lB
lB
Fo
Fo
Fo
Fo
Fo
lD
lD
lD
lD
lD
lD
lD
lD
"}
(35,1,1) = {"
lD
Fo
Fo
Fo
Fo
Fo
Fo
Fo
Fo
Fo
Fo
Fo
Fo
Fo
Fo
dG
Db
JC
JC
JC
JC
JC
DU
JC
Db
JC
JC
JC
Db
dG
lB
Wf
lB
lB
lB
lB
Fo
Fo
Fo
Fo
lD
lD
lD
lD
lD
lD
lD
lD
lD
lD
"}
(36,1,1) = {"
lD
Fo
Fo
Fo
Fo
Fo
Fo
Fo
Fo
Fo
Fo
Fo
Fo
Fo
Fo
dG
pT
pT
pT
pT
pT
pT
pT
fX
fX
fX
pT
pT
pT
dG
lB
lB
lB
lB
lB
Fo
Fo
Fo
Fo
lD
lD
lD
lD
lD
lD
lD
lD
lD
lD
lD
"}
(37,1,1) = {"
lD
lD
Fo
Fo
Fo
Fo
Fo
Fo
Fo
Fo
Fo
Fo
Fo
Fo
Fo
dG
dG
dG
dG
dG
dG
dG
dG
dG
dG
dG
dG
dG
dG
dG
lB
lB
lB
Fo
Fo
Fo
Fo
Fo
lD
lD
lD
lD
lD
lD
lD
lD
lD
lD
lD
lD
"}
(38,1,1) = {"
lD
lD
Fo
Fo
Fo
Fo
Fo
Fo
Fo
Fo
Fo
Fo
Fo
Fo
Fo
Fo
Fo
Fo
Fo
Fo
Fo
Fo
Fo
Fo
Fo
Fo
Fo
Fo
Fo
Fo
Fo
Fo
Fo
Fo
Fo
Fo
Fo
lD
lD
lD
lD
lD
lD
lD
lD
lD
lD
lD
lD
lD
"}
(39,1,1) = {"
lD
lD
lD
lD
lD
Fo
Fo
Fo
Fo
Fo
Fo
Fo
Fo
Fo
Fo
Fo
Fo
Fo
Fo
Fo
Fo
Fo
Fo
Fo
Fo
Fo
Fo
Fo
Fo
Fo
Fo
Fo
Fo
Fo
Fo
Fo
Fo
lD
lD
lD
lD
lD
lD
lD
lD
lD
lD
lD
lD
lD
"}
(40,1,1) = {"
lD
lD
lD
lD
lD
lD
lD
lD
Fo
Fo
Fo
Fo
Fo
Fo
Fo
Fo
Fo
Fo
Fo
Fo
Fo
Fo
Fo
Fo
Fo
Fo
Fo
Fo
Fo
Fo
Fo
Fo
Fo
Fo
Fo
Fo
lD
lD
lD
lD
lD
lD
lD
lD
lD
lD
lD
lD
lD
lD
"}
(41,1,1) = {"
lD
lD
lD
lD
lD
lD
lD
lD
lD
Fo
Fo
Fo
Fo
Fo
tQ
Fo
Fo
Fo
Fo
Fo
Fo
Fo
Fo
Fo
Fo
Fo
Fo
Fo
Fo
Fo
Fo
Fo
Fo
Fo
lD
lD
lD
lD
lD
lD
lD
lD
lD
lD
lD
lD
lD
lD
lD
lD
"}
(42,1,1) = {"
lD
lD
lD
lD
lD
lD
lD
lD
lD
lD
lD
lD
lD
Fo
tQ
tQ
tQ
Fo
Fo
tQ
Fo
Fo
tQ
Fo
Fo
Fo
Fo
Fo
Fo
Fo
Fo
Fo
lD
lD
lD
lD
lD
lD
lD
lD
lD
lD
lD
lD
lD
lD
lD
lD
lD
lD
"}
(43,1,1) = {"
lD
lD
lD
lD
lD
lD
lD
lD
lD
lD
lD
lD
lD
lD
tQ
tQ
tQ
tQ
tQ
tQ
tQ
tQ
tQ
tQ
tQ
Fo
Fo
Fo
Fo
Fo
Fo
lD
lD
lD
lD
lD
lD
lD
lD
lD
lD
lD
lD
lD
lD
lD
lD
lD
lD
lD
"}
(44,1,1) = {"
lD
lD
lD
lD
lD
lD
lD
lD
lD
lD
lD
lD
lD
lD
lD
tQ
tQ
tQ
Fo
tQ
tQ
tQ
tQ
tQ
tQ
tQ
tQ
lD
lD
lD
lD
lD
lD
lD
lD
lD
lD
lD
lD
lD
lD
lD
lD
lD
lD
lD
lD
lD
lD
lD
"}
(45,1,1) = {"
lD
lD
lD
lD
lD
lD
lD
lD
lD
lD
lD
lD
lD
lD
lD
lD
tQ
tQ
Fo
Fo
Fo
tQ
tQ
tQ
tQ
lD
lD
lD
lD
lD
lD
lD
lD
lD
lD
lD
lD
lD
lD
lD
lD
lD
lD
lD
lD
lD
lD
lD
lD
lD
"}
(46,1,1) = {"
lD
lD
lD
lD
lD
lD
lD
lD
lD
lD
lD
lD
lD
lD
lD
lD
Fo
tQ
tQ
tQ
tQ
tQ
IA
tQ
Fo
lD
lD
lD
lD
lD
lD
lD
lD
lD
lD
lD
lD
lD
lD
lD
lD
lD
lD
lD
lD
lD
lD
lD
lD
lD
"}
(47,1,1) = {"
lD
lD
lD
lD
lD
lD
lD
lD
lD
lD
lD
lD
lD
lD
lD
lD
Fo
Fo
tQ
tQ
tQ
Fo
tQ
Fo
Fo
lD
lD
lD
lD
lD
lD
lD
lD
lD
lD
lD
lD
lD
lD
lD
lD
lD
lD
lD
lD
lD
lD
lD
lD
lD
"}
(48,1,1) = {"
lD
lD
lD
lD
lD
lD
lD
lD
lD
lD
lD
lD
lD
lD
lD
lD
lD
Fo
Fo
Fo
Fo
Fo
Fo
Fo
lD
lD
lD
lD
lD
lD
lD
lD
lD
lD
lD
lD
lD
lD
lD
lD
lD
lD
lD
lD
lD
lD
lD
lD
lD
lD
"}
